13 13
1 0 0 0 1 1 1 1 1 1 0 0 0 
1 0 4 0 1 1 1 1 1 1 0 0 0 
2 0 0 0 1 7 7 7 7 7 0 0 0 
0 0 4 0 1 7 0 2 7 0 0 0 0 
1 0 0 0 0 0 2 2 3 4 0 2 0 
1 1 1 0 0 7 0 0 7 0 0 0 0 
1 1 1 0 0 7 7 7 7 7 0 0 0 
0 0 0 0 0 0 0 0 0 0 0 0 0 
0 0 0 0 0 1 1 0 0 0 0 0 0 
0 0 0 0 0 1 1 0 0 0 0 0 0 
0 0 0 0 0 1 0 0 0 0 0 0 0 
0 0 0 0 0 0 0 0 0 0 0 0 0 
0 0 0 0 0 0 0 0 0 0 0 0 0 
