13 13
1 1 0 4 0 0 2 0 0 0 1 1 1 
1 1 0 0 0 1 1 0 4 0 1 1 1 
1 7 7 7 7 7 7 7 0 0 1 1 1 
1 7 0 0 7 0 0 7 0 0 1 1 1 
1 7 0 0 0 0 0 2 0 0 1 1 1 
1 7 2 0 7 2 0 7 0 0 0 0 0 
1 7 7 7 7 7 7 7 0 0 0 4 0 
1 1 1 0 0 0 1 1 0 4 0 0 0 
1 1 1 0 4 0 0 2 0 0 0 0 0 
1 1 1 0 0 3 1 1 1 1 0 4 0 
1 1 1 1 1 1 1 1 1 1 0 0 0 
1 1 1 1 1 1 1 1 1 1 2 0 0 
1 1 1 1 1 1 1 1 1 1 0 0 1 