13 13
1 1 0 0 1 1 1 1 1 1 1 1 1 
1 0 4 0 1 2 1 1 1 1 1 1 1 
1 0 0 0 1 2 1 1 1 1 1 1 1 
1 1 0 0 0 0 1 1 1 1 1 1 1 
0 4 0 0 0 0 1 1 1 1 1 1 1 
0 0 0 0 7 0 1 1 1 1 1 1 1 
1 1 1 0 0 0 1 1 1 1 1 1 1 
1 1 0 0 0 0 0 2 1 1 1 1 1 
0 0 0 0 7 0 1 1 1 1 1 1 1 
0 4 0 0 0 0 1 1 1 1 1 1 1 
1 0 3 0 0 2 0 1 1 1 1 1 1 
1 1 1 1 0 4 0 1 1 1 1 1 1 
1 1 1 1 1 0 0 1 1 1 1 1 1 